9	9	9	9	9	9	9	9	9	9	9	9	9	9	9	9	9	9	9	9	9	9	9	9	9	9	9	9	9	9	9	9	9	9	9	9	9	9	9	9
9	0	0	0	0	0	0	0	0	0	0	0	0	0	0	0	0	0	3	3	3	3	0	0	0	0	0	0	0	0	0	0	0	0	0	0	0	0	0	9
9	0	0	0	0	0	0	0	0	0	0	0	0	0	0	0	0	0	3	3	3	3	0	0	0	0	0	0	0	0	0	0	0	0	0	0	0	0	0	9
9	0	0	0	0	0	0	0	0	0	0	0	0	0	0	0	0	0	0	0	0	0	0	0	0	0	0	0	0	0	0	0	0	0	0	0	0	0	0	9
9	0	0	0	2	0	0	0	0	0	0	0	0	0	0	0	0	0	0	0	0	0	0	0	0	0	0	0	0	0	0	0	0	0	0	2	0	0	0	9
9	0	0	0	0	2	0	0	0	0	0	0	0	0	0	0	0	0	0	0	0	0	0	0	0	0	0	0	0	0	0	0	0	0	2	0	0	0	0	9
9	0	0	0	0	0	2	0	0	0	0	0	0	0	0	0	0	0	0	0	0	0	0	0	0	0	0	0	0	0	0	0	0	2	0	0	0	0	0	9
9	0	0	0	0	0	0	9	0	0	0	0	0	9	0	0	0	0	0	0	0	0	0	0	0	0	9	0	0	0	0	0	9	0	0	0	0	0	0	9
9	0	0	0	0	0	0	0	9	0	0	0	9	0	0	0	0	0	0	0	0	0	0	0	0	0	0	9	0	0	0	9	0	0	0	0	0	0	0	9
9	0	0	0	0	9	2	0	0	9	3	9	0	0	0	0	0	0	0	0	0	0	0	0	0	0	0	0	9	3	9	0	0	2	9	0	0	0	0	9
9	0	0	0	0	9	2	0	0	3	9	3	0	0	0	0	0	0	0	0	0	0	0	0	0	0	0	0	3	9	3	0	0	2	9	0	0	0	0	9
9	0	0	0	0	9	0	0	0	9	3	9	0	0	0	0	0	0	0	0	0	0	0	0	0	0	0	0	9	3	9	0	0	0	9	0	0	0	0	9
9	0	0	0	0	0	0	0	9	0	0	0	9	0	0	0	0	0	0	0	0	0	0	0	0	0	0	9	0	0	0	9	0	0	0	0	0	0	0	9
9	0	0	0	0	0	0	9	0	0	0	0	0	9	0	0	0	1	9	0	0	9	1	0	0	0	9	0	0	0	0	0	9	0	0	0	0	0	0	9
9	0	0	0	0	0	2	2	0	0	0	0	0	0	0	0	1	9	0	0	0	0	9	1	0	0	0	0	0	0	0	0	2	2	0	0	0	0	0	9
9	0	0	0	0	2	0	0	2	0	0	0	0	0	0	1	9	0	0	0	0	0	0	9	1	0	0	0	0	0	0	2	0	0	2	0	0	0	0	9
9	0	0	0	2	0	0	0	0	2	0	0	0	0	1	9	0	0	0	0	0	0	0	0	9	1	0	0	0	0	2	0	0	0	0	2	0	0	0	9
9	0	0	0	9	0	0	0	0	9	0	0	0	1	9	0	0	0	0	0	0	0	0	0	0	9	1	0	0	0	9	0	0	0	0	9	0	0	0	9
9	0	0	0	0	9	3	3	9	0	0	0	0	9	0	0	0	0	3	3	3	3	0	0	0	0	9	0	0	0	0	9	3	3	9	0	0	0	0	9
9	0	0	0	0	3	9	9	3	0	0	0	0	0	0	0	0	0	3	3	3	3	0	0	0	0	0	0	0	0	0	3	9	9	3	0	0	0	0	9
9	0	0	0	0	3	9	9	3	0	0	0	0	0	0	0	0	0	3	3	3	3	0	0	0	0	0	0	0	0	0	3	9	9	3	0	0	0	0	9
9	0	0	0	0	9	3	3	9	0	0	0	0	9	0	0	0	0	3	3	3	3	0	0	0	0	9	0	0	0	0	9	3	3	9	0	0	0	0	9
9	0	0	0	9	0	0	0	0	9	0	0	0	1	9	0	0	0	0	0	0	0	0	0	0	9	1	0	0	0	9	0	0	0	0	9	0	0	0	9
9	0	0	0	2	0	0	0	0	2	0	0	0	0	1	9	0	0	0	0	0	0	0	0	9	1	0	0	0	0	2	0	0	0	0	2	0	0	0	9
9	0	0	0	0	2	0	0	2	0	0	0	0	0	0	1	9	0	0	0	0	0	0	9	1	0	0	0	0	0	0	2	0	0	2	0	0	0	0	9
9	0	0	0	0	0	2	2	0	0	0	0	0	0	0	0	1	9	0	0	0	0	9	1	0	0	0	0	0	0	0	0	2	2	0	0	0	0	0	9
9	0	0	0	0	0	0	9	0	0	0	0	0	9	0	0	0	1	9	0	0	9	1	0	0	0	9	0	0	0	0	0	9	0	0	0	0	0	0	9
9	0	0	0	0	0	0	0	9	0	0	0	9	0	0	0	0	0	0	0	0	0	0	0	0	0	0	9	0	0	0	9	0	0	0	0	0	0	0	9
9	0	0	0	0	9	0	0	0	9	3	9	0	0	0	0	0	0	0	0	0	0	0	0	0	0	0	0	9	3	9	0	0	0	9	0	0	0	0	9
9	0	0	0	0	9	2	0	0	3	9	3	0	0	0	0	0	0	0	0	0	0	0	0	0	0	0	0	3	9	3	0	0	2	9	0	0	0	0	9
9	0	0	0	0	9	2	0	0	9	3	9	0	0	0	0	0	0	0	0	0	0	0	0	0	0	0	0	9	3	9	0	0	2	9	0	0	0	0	9
9	0	0	0	0	0	0	0	9	0	0	0	9	0	0	0	0	0	0	0	0	0	0	0	0	0	0	9	0	0	0	9	0	0	0	0	0	0	0	9
9	0	0	0	0	0	0	9	0	0	0	0	0	9	0	0	0	0	0	0	0	0	0	0	0	0	9	0	0	0	0	0	9	0	0	0	0	0	0	9
9	0	0	0	0	0	2	0	0	0	0	0	0	0	0	0	0	0	0	0	0	0	0	0	0	0	0	0	0	0	0	0	0	2	0	0	0	0	0	9
9	0	0	0	0	2	0	0	0	0	0	0	0	0	0	0	0	0	0	0	0	0	0	0	0	0	0	0	0	0	0	0	0	0	2	0	0	0	0	9
9	0	0	0	2	0	0	0	0	0	0	0	0	0	0	0	0	0	0	0	0	0	0	0	0	0	0	0	0	0	0	0	0	0	0	2	0	0	0	9
9	0	0	0	0	0	0	0	0	0	0	0	0	0	0	0	0	0	0	0	0	0	0	0	0	0	0	0	0	0	0	0	0	0	0	0	0	0	0	9
9	0	0	0	0	0	0	0	0	0	0	0	0	0	0	0	0	0	3	3	3	3	0	0	0	0	0	0	0	0	0	0	0	0	0	0	0	0	0	9
9	0	0	0	0	0	0	0	0	0	0	0	0	0	0	0	0	0	3	3	3	3	0	0	0	0	0	0	0	0	0	0	0	0	0	0	0	0	0	9
9	9	9	9	9	9	9	9	9	9	9	9	9	9	9	9	9	9	9	9	9	9	9	9	9	9	9	9	9	9	9	9	9	9	9	9	9	9	9	9
